{
  "id": 1,
  "height": 12,
  "width": 12,
  "enemies": 20,
  "mapimage": "media/galaxy-bg.png",
  "tileimage": "media/tilebg-8.png",
  "baseimage": "media/galaxy-base.png",
  "towerimage1": "media/galaxy-spaceship.png",
  "layout": [
    0, 0, 11, 0, 0, 0, 0, 0, 0, 0, 0, 0,
    0, 0, 11, 0, 0, 0, 0, 0, 0, 0, 0, 0,
    0, 0, 11, 0, 0, 0, 0, 0, 11, 11, 11, 13,
    0, 0, 11, 0, 0, 0, 0, 0, 11, 0, 0, 0,
    0, 0, 11, 0, 0, 0, 0, 0, 11, 0, 0, 0,
    0, 0, 11, 0, 0, 0, 0, 0, 11, 0, 0, 0,
    0, 0, 11, 0, 0, 0, 0, 0, 11, 0, 0, 0,
    0, 0, 11, 0, 0, 0, 0, 0, 11, 0, 0, 0,
    0, 0, 11, 0, 0, 0, 0, 0, 11, 0, 0, 0,
    0, 0, 11, 11, 11, 11, 11, 11, 11, 0, 0, 0,
    0, 0, 0, 0, 0, 0, 0, 0, 0, 0, 0, 0,
    0, 0, 0, 0, 0, 0, 0, 0, 0, 0, 0, 0
  ]
}